100, 100
1111111111111111111111111111111111111111133333333333333333331111111111111111111111111111111111111111
1111111111111111111111111111111111111111113333333333333333331111111111111111111111111111111111111111
1100000000000000000000000000000000000011110000000000000000111100000000000000000000000000000000001111
1100000000000000000000000000000000000011110000000000000000111100000000000000000000000000000000001111
1100000000000000000000000000000000000011110000000000000000111100000000000000000000000000000000001111
1100000000000000000000000000000000000011110000000000000000000100000000000000000000000000000000001111
1100000000000000000000000000000000000011110000000000000000000000000000000000000000000000000000000111
1100000000000000000000000000000000000011110000000000000000000000000000000000000000000000000000000111
1100000000000000000000000000000000000011110000000000000000000000000000000000000000000000000000000111
1100000000000000000000000000000000000011110000000000000000011100000000000000000000000000000000000111
1100000000000000000000000000000000000011110000000000000000111100000000000000000000000000000000000111
1100000000000000000000000000000000000111110000000000000000111100000000000000000000000000000000000111
1101111111000000000000000000010100111111110000000000000000111100000000000000000000000000000000000111
1111111111110101010010010010111111111111110000000000000000111100000000000000000000000000000000000111
1111111111111111111111111111111111111111110000000000000000111100000000000000000000000000000000000111
1111111111111111111111111111111111111111110000000000000000111100000000000000000000000000000000000111
1111111111111111111111111111000000000011110000000000000000111100000000000000000000000000000000000111
1111111111110000000000000000000000000000000000000000000000111100000000000000000000000000000000000111
1110000001110000000000000000000000000000000000000000000000111100000000000000000000000000000000000111
1100000000000000000000000000000000000000000000000000000000111100000000000000000000000000000000003111
1100000000000000000000000000000000000000000000000000000000111100000000000000000000000000000000033311
1100000000000000000000000000000000000000000000000000000000111100000000000000000000000000000000333311
1100000000000000000000000000000000000000000000000000000000111100000000000000000000000000000000333311
1100000000000000000000000000000000000011110000000000000000111100000000000000000000000000000000033311
1100000000000000000000000000000000000011110000000000000000111100000000000000000000000000000000000111
1100000000000000000000000000000000000011110000000000000000111110000000000000000000000000000000000111
1100000000000000000000000000000000000011110000000000000000111111000000000000000000000000000000000111
1100000000000000000000000000000000000011110000000000000000111111100000000000000000000000000000000111
1100000000000000000000000000000000000011110000000000000000111111110100100000000000000001110101110111
1100000000000000000000000000000000000011110000000000000000111111111111110100101111010111111111111111
1100000000000000000000000000000000000011110000000000000000111101111111111111111111111111111111111111
1200000000000000000000000000000000000011110000000000000000111100001111111111111111111111111111111111
2220000000000000000000000000000000000011110000000000000000111100000000001111111111111111111111100111
2220000000000000000000000000000000000011110000000000000000111100000000000000000000000001111111100111
2220000000000000000000000000000000000011110000000000000000111100000000000000000000000000000000000111
2220000000000000000000000000000000000011110000000000000000111100000000000000000000000000000000000111
2220000000000000000000000000000000000011110000000000000000111100000000000000000000000000000000000111
1100000000000000000000000000000000000011110000000000000000111100000000000000000000000000000000000111
1100000000000000000000000000000000000011110000000000000000111100000000000000000000000000000000000111
1100000000000000000000000000000000000011110000000000000000111100000000000000000000000000000000000111
1100000000000000000000000000000000000011110000000000000000111100000000000000000000000000000000000111
1100000000000000000000000000000000000011110000000000000000111100000000000000000000000000000000000111
1100001111000000000000000000000000000011110000000000000000111100000000000000000000000000000000000111
1110011111111110000000101111101000000011110000000000000000111100000000000000000000000000000000000111
1111111111111111111111111111111111011111110000000000000000111100000000000000000000000000000000000111
1111111111111111111111111111111111111111110000000000000000111100000000000000000000000000000000000111
1111111111111111111111111111111111111111110000000000000000111100000000000000000000000000000000000111
1100001111100001111111000000011111111111110000000000000000111100000000000000000000000000000000000111
1100000000000000000000000000000000000011110000000000000000111100000000000000000000000000000000000111
1100000000000000000000000000000000000011110000000000000000001000000000000000000000000000000000000111
1100000000000000000000000000000000000011110000000000000000000000000000000000000000000000000000003111
1100000000000000000000000000000000000011110000000000000000000000000000000000000000000000000000033311
1100000000000000000000000000000000000000000000000000000000000000000000000000000000000000000000333311
1100000000000000000000000000000000000000000000000000000000000000000000000000000000000000000000333311
1100000000000000000000000000000000000000000000000000000000000000000000000000000000000000000000033311
1100000000000000000000000000000000000000000000000000000001111000000000000000000000000000000000000111
1100000000000000000000000000000000000000000000000000000001111000000000000000000000000000000000000111
1100000000000000000000000000000000000011110000000000000001111000000000000000000000000000000000000111
1100000000000000000000000000000000000011110000000000000001111000000000000000000000000000000000000111
1100000000000000000000000000000000000011110000000000000001111000000000000000000000000001111111111111
1100000000000000000000000000000000000011110000000000000001111000101101111011010101011111111111111111
1100000000000000000000000000000000000011110000000000000001111111111111111111111111111111111111111111
1100000000000000000000000000000000000011110000000000000001111111111111111111111111111111111111111111
1100000000000000000000000000000000000011110000000000000001111111111111111111111111111111111111000111
1100000000000000000000000000000000000011110000000000000001111111111011100111000000000000011111000111
1100000000000000000000000000000000000011110000000000000001111000000000000000000000000000000000000111
1200000000000000000000000000000000000011110000000000000001111000000000000000000000000000000000000111
2220000000000000000000000000000000000011110000000000000001001000000000000000000000000000000000000111
2220000000000000000000000000000000000011110000000000000000000000000000000000000000000000000000000111
2220000000000000000000000000000000000011110000000000000000000000000000000000000000000000000000001111
2220000000000000000000000000000000000011110000000000000000000000000000000000000000000000000000001111
2220000000000000000000000000000000000011110000000000000000000000000000000000000000000000000000000111
2220000000000000000000000000000000000011110000000000000000000000000000000000000000000000000000001111
1100000000000000000000000000000000000011110000000000000001000000000000000000000000000000000000001111
1100000000000000000000000000000000000011110000000000000001111000000000000000000000000000000000001111
1100000000000000000000000000000000000011110000000000000001111000000000000000000000000000000000001111
1100000000000000000000000000000000000011110000000000000001111000000000000000000000000000000000001111
1100000000000000000000000000000000000011110000000000000001111000000000000000000000000000000000001111
1101101111111010101110110101101111111011110000000000000001111000000000000000000000000000000000001111
1111111111111111111111111111111111111111110000000000000001111000000000000000000000000000000000001111
1111111111111111111111111111111111111111110000000000000001111000000000000000000040000000000000001111
1111111111111111111111111111111111111111110000000000000001111000000000000000004444000000000000001111
1100011112000000000000000000000000001111110000000000000001111000000000000000044444400000000000001111
1100000000000000000000000000000000000011110000000000000001111000000000000000444444440000000000000111
1100000000000000000000000000000000000011110000000000000001111000000000000000444444440000000000000111
1100000000000000000000000000000000000011110000000000000001111000000000000000044444440000000000000111
1100000000000000000000000000000000000011110000000000000001111000000000000000000444000000000000000111
1200000000000000000000000000000000000000000000000000000001111000000000000000000000000000000000000011
2220000000000000000000000000000000000000000000000000000001111000000000000000000000000000000000033111
2220000000000000000000000000000000000000000000000000000001111000000000000000000000000000000000333311
2220000000000000000000000000000000000000000000000000000001111000000000000000000000000000000003333311
2220000000000000000000000000000000000000000000000000000001111000000000000000000000000000000000333311
2220000000000000000000000000000000000011110000000000000001111000000000000000000000000000000000033311
1100000000000000000000000000000000000111110000000000000001111000000000000000000000000000000000000111
1100000000000000000000000000000000000111110000000000000001111000000000000000000000000000000000000111
1100000000000000000000000000000000000011111000000000000001111111010100100100001000100001000000000111
1100000000000000000000000000000011111111110101010000000001111111111111111110011101110011101001011111
1111111111110111101101011111111111111111111111111111010111111111111111111111111111111111111111111111
1111111111111111111111111111111111111111111111111111111111111111111111111111111111111111111111111111
1111111111111111111111111111111111111111111111111111111111111111111111111111111111111111111111111111
