100, 100
1111111111111111111111111111111111111113333333333333333333331111111111111111111111111111111111111111
1111111111111111111111111111111111111113333333333333333333331111111111111111111111111111111111111111
1100000000000000000000000000000000000110000000000000000000001100000000000000000000000000000000000011
1100000000000000000000000000000000000110000000000000000000001100000000000000000000000000000000000011
1100000000000000000000000000000000000110000000000000000000001100000000000000000000000000000000000011
1100000000000000555500000000000000000000000000000000000000001100000000000000000000000000000000000033
1100000000000000555500000000000000000000000000000000000000001100000000000000000000000000000000000033
1100000000000000555500000000000000000000000000000000000000001100000000000000000000000000000000000033
1100000000000000555500000000000000000000000000000000000000001100000000000000000000000000000000000033
1100000000000000000000000000000000000000000000000000000000000000000000000000000000000000000000000033
1100000000000000000000000000000000000110000000000000000000000000000000000000000000000000000000000033
1100000000000000000000000000000000000110000000000000000000000000000000000000000000000000000000000033
1100000000000000000000000000000000000110000000000000000000000000000000000000000000000000000000000033
1111111111111111100000001111111111111110000000000000000000000000000000000000000000000000000000000033
1111111111111111100000001111111111111110000000000000000000000000000000000000000000000000000000000011
1100000000000000000000000000000000000110000000000000000000000000000000000000000000000000000000000011
1100000000000000000000000000000000000110000000000000000000000000000000000000005555000000000000000011
1100000000000000000000000000000000000110000000000000000000000000000000000000005555000000000000000011
1100000000000000000000000000000000000110000000000000000000000000000000000000005555000000000000000011
1100000000000000000000000000000000000110000000000000000000000000000000000000005555000000000000000011
1100000000000000000000000000000000000110000000000000000000001100000000000000000000000000000000000011
1100000000000000000000000000000000000000000000000000000000001100000000000000000000000000000000000011
1100000000000000000000000000000000000000000000000000000000001100000000000000000000000000000000000011
1100000000000000000000000000000000000000000000000000000000001100000000000000000000000000000000000011
1100000000000000000000000000000000000000000000000000000000001111111111111111111111111111111111111111
1100000000000000444400000000000000000000000000000000000000001111111111111111111111111111111111111111
1100000000000000444400000000000000000000000000000000000000001100000000000000000000000000000000000011
1100000000000000444400000000000000000000000000000000000000001100000000000000000000000000000000000011
1100000000000000444400000000000000000000000000000000000000001100000000000000000000000000000000000011
1100000000000000000000000000000000000000000000000000000000001100000000000000000000000000000000000033
1100000000000000000000000000000000000110000000000000000000001100000000000000000000000000000000000033
1100000000000000000000000000000000000110000000000000000000001100000000000000000000000000000000000033
1100000000000000000000000000000000000110000000000000000000001100000000000000000000000000000000000033
1100000000000000000000000000000000000110000000000000000000001100000000000000000000000000000000000033
1100000000000000000000000000000000000110000000000000000000001100000000000000000000000000000000000033
1100000000000000000000000000000000000110000000000000000000001100000000000000000000000000000000000033
2100000000000000000000000000000000000110000000000000000000001100000000000000000000000000000000000033
2200000000000000000000000000000000000110000000000000000000001100000000000000000000000000000000000033
2200000000000000000000000000000000000110000000000000000000001100000000000000000000000000000000000033
2200000000000000000000000000000000000110000000000000000000001100000000000000000000000000000000000033
2200000000000000000000000000000000000110000000000000000000000000000000000000000000000000000000000011
2200000000000000000000000000000000000110000000000000000000000000000000000000000000000000000000000011
1111111111111111111111111111111111111110000000000000000000000000000000000000000000000000000000000011
1111111111111111111111111111111111111110000000000000000000000000000000000000000000000000000000000011
1100000000000000000000000000000000000110000000000000000000000000000000000000000000000000000000000011
1100000000000000000000000000000000000110000000000000000000000000000000000000555500000000000000000011
1100000000000000000000000000000000000110000000000000000000000000000000000000555500000000000000000011
1100000000000000000000000000000000000110000000000000000000000000000000000000555500000000000000000011
1100000000000000000000000000000000000110000000000000000000000000000000000000555500000000000000000011
1100000000000000000000000000000000000110000000000000000000000000000000000000000000000000000000000011
1100000000000000000000000000000000000110000000000000000000001100000000000000000000000000000000000011
1100000000000000000000000000000000000110000000000000000000001100000000000000000000000000000000000011
1100000000000000000000000000000000000110000000000000000000001100000000000000000000000000000000000011
1100000000000000000000000000000000000110000000000000000000001100000000000000000000000000000000000011
1100000000000000000000000000000000000000000000000000000000001100000000000000000000000000000000000011
1100000000000000000000000000000000000000000000000000000000001100000000000000000000000000000000000011
1100000000000000000000000000000000000000000000000000000000001100000000000000000000000000000000000011
1100000000000000000000000000000000000000000000000000000000001100000000000000000000000000000000000011
1100000000000000000000000000000000000000000000000000000000001100000000000000000000000000000000000011
1100000000000000000000000000000000000000000000000000000000001100000000000000000000000000000000000011
1100000000000000000000000000000000000000000000000000000000001100000000000000000000000000000000000011
1100000000000004444000000000000000000000000000000000000000001100000000000000000000000000000000000011
1100000000000004444000000000000000000000000000000000000000001111111111111111111111111111111111111111
1100000000000004444000000000000000000000000000000000000000001111111111111111111111111111111111111111
1100000000000004444000000000000000000110000000000000000000001100000000000000000000000000000000000011
1100000000000000000000000000000000000110000000000000000000001100000000000000000000000000000000000011
1100000000000000000000000000000000000110000000000000000000001100000000000000000000000000000000000011
1100000000000000000000000000000000000110000000000000000000001100000000000000000000000000000000000011
1100000000000000000000000000000000000110000000000000000000001100000000000000000000000000000000000011
1100000000000000000000000000000000000110000000000000000000001100000000000000000000000000000000000011
1100000000000000000000000000000000000110000000000000000000001100000000000000000000000000000000000011
2200000000000000000000000000000000000110000000000000000000001100000000000000000000000000000000000011
2200000000000000000000000000000000000110000000000000000000001100000000000000005555000000000000000011
2200000000000000000000000000000000000110000000000000000000000000000000000000005555000000000000000011
2200000000000000000000000000000000000110000000000000000000000000000000000000005555000000000000000011
2200000000000000000000000000000000000110000000000000000000000000000000000000005555000000000000000011
1111111111111111111111111111111111111110000000000000000000000000000000000000000000000000000000000011
1111111111111111111111111111111111111110000000000000000000000000000000000000000000000000000000000011
1100000000000000000000000000000000000110000000000000000000000000000000000000000000000000000000000011
1100000000000000000000000000000000000110000000000000000000000000000000000000000000000000000000000011
1100000000000000000000000000000000000110000000000000000000000000000000000000000000000000000000000011
1100000000000000000000000000000000000110000000000000000000000000000000000000000000000000000000000011
1100000000000000000000000000000000000110000000000000000000000000000000000000000000000000000000000033
1100000000000000000000000000000000000000000000000000000000000000000000000000000000000000000000000033
1100000000000000000000000000000000000000000000000000000000001100000000000000000000000000000000000033
1100000000000000000000000000000000000000000000000000000000001100000000000000000000000000000000000033
1100000000000000044440000000000000000000000000000000000000001100000000000000000000000000000000000033
1100000000000000044440000000000000000000000000000000000000001100000000000000000000000000000000000033
1100000000000000044440000000000000000000000000000000000000001100000000000000000000000000000000000033
1100000000000000044440000000000000000000000000000000000000001100000000000000000000000000000000000033
1100000000000000000000000000000000000000000000000000000000001100000000000000000000000000000000000033
1100000000000000000000000000000000000110000000000000000000001100000000000000000000000000000000000011
1100000000000000000000000000000000000110000000055550000000001100000000000000000000000000000000000011
1100000000000000000000000000000000000110000000055550000000001100000000000000000000000000000000000011
2200000000000000000000000000000000000110000000055550000000001100000000000000000000000000000000000011
2200000000000000000000000000000000000110000000055550000000001100000000000000000000000000000000000011
2200000000000000000000000000000000000110000000000000000000001100000000000000000000000000000000000011
2200000000000000000000000000000000000110000000000000000000001100000000000000000000000000000000000011
1111111111111111111111111111111111111111111111111111111111111111111111111111111111111111111111111111
1111111111111111111111111111111111111111111111111111111111111111111111111111111111111111111111111111
