100, 100
1111111111111111111111111111111111111113333333333333333333331111111111111111111111111111111111111111
1111111111111111111111111111111111111113333333333333333333331111111111111111111111111111111111111111
1100000000000000000000000000000000000110000000000000000000001100000000000000000000000000000000000011
1100000000000000000000000000000000000110000000000000000000001100000000000000000000000000000000000011
1100000000000000000000000000000000000110000000000000000000001100000000000000000000000000000000000011
1100000000000000000000000000000000000110000000000000000000001100000000000000000050000000000000000033
1100000000000000000000000000000000000110000000000000000000001100000000000000055555550000000000000033
1100000000000000000000000000000000000110000000000000000000001100000000000000555555555000000000000033
1100000000000000000000000000000000000110000000000000000000001100000000000005555555555500000000000033
1100000000000000000000000000000000000110000000000000000000000000000000000005555555555500000000000033
1100000000000000000000000000000000000110000000000000000000000000000000000005555555555500000000000033
1100000000000000000000000000000000000110000000000000000000000000000000000055555555555500000000000033
1100000000000000000000000000000000000110000000000000000000000000000000000005555555555500000000000033
1111111111111111111111111111111111111110000000000000000000000000000000000005555555555500000000000033
1111111111111111111111111111111111111110000000000000000000000000000000000005555555555500000000000033
1100000000000000000000000000000000000110000000000000000000000000000000000000555555555000000000000033
1100000000000000000000000000000000000110000000000000000000001100000000000000055555550000000000000033
1100000000000000000000000000000000000110000000000000000000001100000000000000000000000000000000000033
1100000000000000000000000000000000000110000000000000000000001100000000000000000000000000000000000011
1100000000000000000000000000000000000110000000000000000000001100000000000000000000000000000000000011
1100000000000000000000000000000000000110000000000000000000001100000000000000000000000000000000000011
1100000000000000000400000000000000000110000000000000000000001100000000000000000000000000000000000011
1100000000000000444444400000000000000110000000000000000000001100000000000000000000000000000000000011
1100000000000004444444440000000000000110000000000000000000001100000000000000000000000000000000000011
1100000000000044444444444000000000000000000000000000000000001111111111111111111111111111111111111111
1100000000000044444444444000000000000000000000000000000000001111111111111111111111111111111111111111
1100000000000044444444444000000000000000000000000000000000001100000000000000000000000000000000000011
1100000000000444444444444000000000000000000000000000000000001100000000000000000000000000000000000011
1100000000000044444444444000000000000000000000000000000000001100000000000000000000000000000000000011
1100000000000044444444444000000000000000000000000000000000001100000000000000000000000000000000000011
1100000000000044444444444000000000000110000000000000000000001100000000000000000000000000000000000011
1200000000000004444444440000000000000110000000000000000000001100000000000000000000000000000000000011
2220000000000000444444400000000000000110000000000000000000001100000000000000000000000000000000000011
2220000000000000000000000000000000000110000000000000000000001100000000000000000000000000000000000011
2220000000000000000000000000000000000110000000000000000000001100000000000000000000000000000000000011
2220000000000000000000000000000000000110000000000000000000001100000000000000000000000000000000000011
2220000000000000000000000000000000000110000000000000000000001100000000000000000000000000000000000011
1100000000000000000000000000000000000110000000000000000000001100000000000000000000000000000000000033
1100000000000000000000000000000000000110000000000000000000001100000000000000000000000000000000000033
1100000000000000000000000000000000000110000000000000000000001100000000000000000000000000000000000033
1100000000000000000000000000000000000110000000000000000000000000000000000000000000000000000000000033
1100000000000000000000000000000000000110000000000000000000000000000000000000000000000000000000000033
1111111111111111111111111111111111111110000000000000000000000000000000000000000000000000000000000033
1111111111111111111111111111111111111110000000000000000000000000000000000000000000000000000000000033
1100000000000000000000000000000000000110000000000000000000000000000000000000000005000000000000000033
1100000000000000000000000000000000000110000000000000000000000000000000000000005555555000000000000033
1100000000000000000000000000000000000110000000000000000000001100000000000000055555555500000000000033
1100000000000000000000000000000000000110000000000000000000001100000000000000555555555550000000000011
1100000000000000000000000000000000000110000000000000000000001100000000000000555555555550000000000011
1100000000000000000000000000000000000110000000000000000000001100000000000000555555555550000000000011
1100000000000000004000000000000000000110000000000000000000001100000000000005555555555550000000000011
1100000000000004444444000000000000000110000000000000000000001100000000000000555555555550000000000011
1100000000000044444444400000000000000110000000000000000000001100000000000000555555555550000000000011
1100000000000444444444440000000000000110000000000000000000001100000000000000555555555550000000000011
1100000000000444444444440000000000000110000000000000000000001100000000000000055555555500000000000011
1100000000000444444444440000000000000110000000000000000000001100000000000000005555555000000000000011
1100000000004444444444440000000000000000000000000000000000001100000000000000000000000000000000000011
1100000000000444444444440000000000000000000000000000000000001100000000000000000000000000000000000011
1100000000000444444444440000000000000000000000000000000000001100000000000000000000000000000000000011
1100000000000444444444440000000000000000000000000000000000001100000000000000000000000000000000000011
1100000000000044444444400000000000000000000000000000000000001100000000000000000000000000000000000011
1100000000000004444444000000000000000000000000000000000000001100000000000000000000000000000000000011
1100000000000000000000000000000000000110000000000000000000001111111111111111111111111111111111111111
1100000000000000000000000000000000000110000000000000000000001111111111111111111111111111111111111111
1100000000000000000000000000000000000110000000000000000000001100000000000000000000000000000000000011
1100000000000000000000000000000000000110000000000000000000001100000000000000000000000000000000000011
1200000000000000000000000000000000000110000000000000000000001100000000000000000000000000000000000011
2220000000000000000000000000000000000110000000000000000000001100000000000000000000000000000000000011
2220000000000000000000000000000000000110000000000000000000001100000000000000000000000000000000000011
2220000000000000000000000000000000000110000000000000000000001100000000000000000000000000000000000011
2220000000000000000000000000000000000110000000000000000000001100000000000000000000000000000000000011
2220000000000000000000000000000000000110000000000000000000001100000000000000000000000000000000000011
2220000000000000000000000000000000000110000000000000000000001100000000000000000000000000000000000011
1100000000000000000000000000000000000110000000000000000000001100000000000000000000000000000000000011
1100000000000000000000000000000000000110000000000000000000001100000000000000000000000000000000000011
1100000000000000000000000000000000000110000000000000000000001100000000000000000000000000000000000011
1111111111111111111111111111111111111110000000000000000000001100000000000000000050000000000000000011
1111111111111111111111111111111111111110000000000000000000000000000000000000055555550000000000000011
1100000000000000000000000000000000000110000000000000000000000000000000000000555555555000000000000011
1100000000000000000000000000000000000110000000000000000000000000000000000005555555555500000000000011
1100000000000000000000000000000000000110000000000000000000000000000000000005555555555500000000000011
1100000000000000000400000000000000000110000000000000000000000000000000000005555555555500000000000011
1100000000000000444444400000000000000110000000000000000000000000000000000055555555555500000000000033
1100000000000004444444440000000000000110000000000000000000001100000000000005555555555500000000000033
1100000000000044444444444000000000000110000000000000000000001100000000000005555555555500000000000033
1100000000000044444444444000000000000000000000000000000000001100000000000005555555555500000000000033
1100000000000044444444444000000000000000000000000000000000001100000000000000555555555000000000000033
1200000000000444444444444000000000000000000000000000000000001100000000000000055555550000000000000033
2200000000000044444444444000000000000000000000000000000000001100000000000000000000000000000000000033
2200000000000044444444444000000000000000000000000000000000001100000000000000000000000000000000000011
2200000000000044444444444000000000000000000000000000000000001100000000000000000000000000000000000011
2200000000000004444444440000000000000110000000000000000000001100000000000000000000000000000000000011
2200000000000000444444400000000000000110000000000000000000001100000000000000000000000000000000000011
1100000000000000000000000000000000000110000000000000000000001100000000000000000000000000000000000011
1100000000000000000000000000000000000110000000000000000000001100000000000000000000000000000000000011
1100000000000000000000000000000000000110000000000000000000001100000000000000000000000000000000000011
1100000000000000000000000000000000000110000000000000000000001100000000000000000000000000000000000011
1100000000000000000000000000000000000110000000000000000000001100000000000000000000000000000000000011
1111111111111111111111111111111111111111111111111111111111111111111111111111111111111111111111111111
1111111111111111111111111111111111111111111111111111111111111111111111111111111111111111111111111111
