100, 100
1111111111111111111111111111111111111111111111111111111111111111111111111111111111111111111111111111
1111111111111111111111111111111111111111111111111111111111111111111111111111111111111111111111111111
1111111111111111111111111111111111111111111111111111111111111111111111111111111111111111111111111111
1111111111111111111111111111111111111111111111111111111111111111111111111111111111111111111111111111
1111110000000000000000000000000000000000000111111111111111111111111111111111111111111111111111111111
1111110000000000000000000000000000000000000011111111100011111111111111111111111111000000000001111111
1111110000000000000000000000000000000000000011111111000000000000000000000000000000000000000001111111
1111110000000000000000000000000000000000000011111111000000000000000000000000000000000000000001111111
1111110000000000000000000000000000000000000011111111000000000000000000000000000000000000000001111111
1111110000000000000000000000000000000000000011111111000000000000000000000000000000000000000001111111
1111110000000000000000000000000000000000000011111111000000000000000000000000000000000000000001111111
1111110000000000000000000000000000000000000011111111100000000000000000000000000000000000000001111111
1111110000000000000000000000000000000000000011111111100000000000000000000000000000000000000011111111
1111110000000000000000000000000000000000000011111111100000000000000000000000000000000000000011111111
1111110000000000000000000000000000000000000011111111100000000000000000000000000000000000000011111111
1111110000000000000000000000000000000000000001111111100000000000000000000000000000000000000011111111
1111110000000000000000000000000000000000000001111111100000000000000000000000000000000000000011111111
1111110000000000000000000000000000000000000011111111100000000000000000000000000000000000000011111111
1111110000000000000000000000000000000000000011111111100000000000000000000000000000000000000011111111
1111110000000000000000000000000000000000000011111111100000000000000000000000000000000000000011111111
1111110000000000000000000000000000000000000011111111100000000000000000000000000000000000000011111111
1111110000000000000000000000000000000000000111111111100000000000000000000000000000000000000011111111
1111110000000000000000000000000000000000000111111111100000000000000000000000000000000000000011111111
1111110000000000000000000000000000000000000111111111000000000000000000000000000000000000000011111111
1111110000000000000000000000000000000000000111111111000000000000000000000000000000000000000011111111
1111110000000000000000000000000000000000000111111111000000000000000000000000000000000000000001111111
1111110000000000000000000000000000000000000111111111000000000000000000000000000000000000000001111111
1111110000000000000000000000000000000000000111111111000000000000000000000000000000000000000001111111
1111110000000000000000000000000000000000000111111111000000000000000000000000000000000000000001111111
1111110000000000000000000000000000000000000111111111100000000000000000000000000000000000000001111111
1111110000000000000000000000000000000000000111111111100000000000000000000000000000000000000001111111
1111110000000000000000000000000000000000000011111111100000000000000000000000000000000000000001111111
1111110000000000000000000000000000000000000011111111100000000000000000000000000000000000000001111111
1111110000000000000000000000000000000000000011111111100000000000000000000000000000000000000001111111
1111110000000000000000000000000000000000000011111111100000000000000000000000000000000000000001111111
2222210000000000000000000000000000000000000011111111100000000000000000000000000000000000000001111111
2222222000000000000000000000000000000000000001111111100000000000000000000000000000000000000001111111
2222222000000000000000000000000000000000000001111111100000000000000000000000000000000000000001111111
2222222000000000000000000000000000000000000001111111100000000000000000000000000000000000000001111111
2222222000000000000000000000000000000000000001111111100000000000000000000000000000000000000003333333
2222222000000000000000000000000000000000000001111111100000000000000000000000000000000000000333333333
2222222000000000000000000000000000000000000000000000000000000000000000000000000000000000000333333333
2222222000000000000000000000000000000000000000000000000000000000000000000000000000000000000333333333
2222222000000000000000000000000000000000000000000000000000000000000000000000000000000000000333333333
2222222000000000000000000000000000000000000000000000000000000000000000000000000000000000000333333333
2222222000000000000000000000000000000000000000000000000000000000000000000000000000000000000333333333
2222222000000000000000000000000000000000000000000000000000000000000000000000000000000000000333333333
2222220000000000000000000000000000000000000000000000000000000000000000000000000000000000000333333333
2222220000000000000000000000000000000000000000000000000000000000000000000000000000000000000333333333
2222220000000000000000000000000000000000000111111110000000000000000000000000000000000000000003333333
1111110000000000000000000000000000000000000111111110000000000000000000000000000000000000000000333333
1111110000000000000000000000000000000000000111111110000000000000000000000000000000000000000000111111
1111110000000000000000000000000000000000000111111110000000000000000000000000000000000000000000111111
1111100000000000000000000000000000000000000111111110000000000000000000000000000000000000000000111111
1111100000000000000000000000000000000000000111111110000000000000000000000000000000000000000000111111
1111100000000000000000000000000000000000000111111110000000000000000000000000000000000000000000111111
1111100000000000000000000000000000000000000111111111000000000000000000000000000000000000000000111111
1111100000000000000000000000000000000000000011111111000000000000000000000000000000000000000000111111
1111100000000000000000000000000000000000000011111111000000000000000000000000000000000000000000011111
1111100000000000000000000000000000000000000011111111000000000000000000000000000000000000000000011111
1111100000000000000000000000000000000000000011111111000000000000000000000000000000000000000000011111
1111100000000000000000000000000000000000000011111111000000000000000000000000000000000000000000011111
1111100000000000000000000000000000000000000011111111000000000000000000000000000000000000000000011111
1111100000000000000000000000000000000000000011111111000000000000000000000000000000000000000000011111
1111100000000000000000000000000000000000000011111111000000000000000000000000000000000000000000011111
1111100000000000000000000000000000000000000011111111000000000000000000000000000000000000000000011111
1111100000000000000000000000000000000000000011111111000000000000000000000000000000000000000000011111
1111100000000000000000000000000000000000000011111111000000000000000000000000000000000000000000111111
1111100000000000000000000000000000000000000011111111000000000000000000000000000000000000000000111111
1111100000000000000000000000000000000000000111111111000000000000000000000000000000000000000000111111
1111100000000000000000000000000000000000000111111111000000000000000000000000000000000000000000111111
1111100000000000000000000000000000000000000111111111000000000000000000000000000000000000000000111111
1111100000000000000000000000000000000000000111111111000000000000000000000000000000000000000000111111
1111100000000000000000000000000000000000000111111111000000000000000000000000000000000000000000111111
1111100000000000000000000000000000000000000111111111000000000000000000000000000000000000000000111111
1111100000000000000000000000000000000000000111111111000000000000000000000000000000000000000000111111
1111000000000000000000000000000000000000000111111110000000000000000000000000000000000000000000111111
1111000000000000000000000000000000000000000111111110000000000000000000000000000000000000000000111111
1111000000000000000000000000000000000000000111111110000000000000000000000000000000000000000000111111
1111000000000000000000000000000000000000000111111110000000000000000000000000000000000000000000111111
1111000000000000000000000000000000000000000111111110000000000000000000000044440000000000000000111111
1111000000000000000000000000000000000000000111111110000000000000000000000044444000000000000001111111
1111000000000000000000000000000000000000000111111110000000000000000000000044444000000000000001111111
1111000000000000000000000000000000000000000111111110000000000000000000000044444000000000000001111111
1111000000000000000000000000000000000000000111111110000000000000000000000044444000000000000001111111
1111000000000000000000000000000000000000000111111110000000000000000000000000000000000000000001111111
1111000000000000000000000000000000000000000111111111000000000000000000000000000000000000000001111111
1111000000000000000000000000000000000000000111111111000000000000000000000000000000000000000001111111
1111000000000000000000000000000000000000000111111111000000000000000000000000000000000000000001111111
1111000000000000000000000000000000000000000111111111000000000000000000000000000000000000000001111111
1111000000000000000000000000000000000000000011111111000000000000000000000000000000000000000001111111
1111000000000000000000000000000000000000000011111111000000000000000000000000000000000000000001111111
1111000000000000000000000000000000000000000011111111000000000000000000000000000000000000000001111111
1111110000000000000011111111111111111111111111111111111111000000000000000000000000000000011111111111
1111110011111111111111111111111111111111111111111111111111000000000111111111111111111111111111111111
1111111111111111111111111111111111111111111111111111111111111111111111111111111111111111111111111111
1111111111111111111111111111111111111111111111111111111111111111111111111111111111111111111111111111
1111111111111111111111111111111111111111111111111111111111111111111111111111111111111111111111111111
1111111111111111111111111111111111111111111111111111111111111111111111111111111111111111111111111111
1111111111111111111111111111111111111111111111111111111111111111111111111111111111111111111111111111
