100, 100
1111111111111111111111111111111111111111111111111111111111111111111111111111111111111111111111111111
1111111111111111111111111111111111111111111111111111111111111111111111111111111111111111111111111111
2200000000000000000000000000000000000000000000000000000000000000000000000000000000000000000000000033
2200000000000000000000000000000000000000000000000000000000000000000000000000000000000000000000000033
2200000000000000000000000000000000000000000000000000000000000000000000000000000000000000000000000033
2200000000000000000000000000000000000000000000000000000000000000000000000000000000000000000000000033
2200000000000000000000000000000000000000000000000000000000000000000000000000000000000000000000000033
2200000000000000000000000000000000000000000000000000000000000000000000000000000000000000000000000033
2200000000000000000000000000000000000000000000000000000000000000000000000000000000000000000000000033
2200000000000000000000000000000000000000000000000000000000000000000000000000000000000000000000000033
2200000000000000000000000000000000000000000000000000000000000000000000000000000000000000000000000033
2200000000000000000000000000000000000000000000000000000000000000000000000000000000000000000000000033
2200000000000000000000000000000000000000000000000000000000000000000000000000000000000000000000000033
2200000000000000000000000000000000000000000000000000000000000000000000000000000000000000000000000033
2200000000000000000000000000000000000000000000000000000000000000000000000000000000000000000000000033
2200000000000000000000000000000000000000000000000000000000000000000000000000000000000000000000000033
2200000000000000000000000000000000000000000000000000000000000000000000000000000000000000000000000033
2200000000000000000000000000000000000000000000000000000000000000000000000000000000000000000000000033
2200000000000000000000000000000000000000000000000000000000000000000000000000000000000000000000000033
2200000000000000000000000000000000000000000000000000000000000000000000000000000000000000000000000033
2200000000000000000000000000000000000000000000000000000000000000000000000000000000000000000000000033
2200000000000000000000000000000000000000000000000000000000000000000000000000000000000000000000000033
2200000000000000000000000000000000000000000000000000000000000000000000000000000000000000000000000033
2200000000000000000000000000000000000000000000000000000000000000000000000000000000000000000000000033
2200000000000000000000000000000000000000000000000000000000000000000000000000000000000000000000000033
2200000000000000000000000000000000000000000000000000000000000000000000000000000000000000000000000033
2200000000000000000000000000000000000000000000000000000000000000000000000000000000000000000000000033
2200000000000000000000000000000000000000000000000000000000000000000000000000000000000000000000000033
2200000000000000000000000000000000000000000000000000000000000000000000000000000000000000000000000033
2200000000000000000000000000000000000000000000000000000000000000000000000000000000000000000000000033
2200000000000000000000000000000000000000000000000000000000000000000000000000000000000000000000000033
2200000000000000000000000000000000000000000000000000000000000000000000000000000000000000000000000033
2200000000000000000000000000000000000000000000000000000000000000000000000000000000000000000000000033
2200000000000000000000000000000000000000000000000000000000000000000000000000000000000000000000000033
2200000000000000000000000000000000000000000000000000000000000000000000000000000000000000000000000033
2200000000000000000000000000000000000000000000000000000000000000000000000000000000000000000000000033
2200000000000000000000000000000000000000000000000000000000000000000000000000000000000000000000000033
2200000000000000000000000000000000000000000000000000000000000000000000000000000000000000000000000033
2200000000000000000000000000000000000000000000000000000000000000000000000000000000000000000000000033
2200000000000000000000000000000000000000000000000000000000000000000000000000000000000000000000000033
2200000000000000000000000000010000000000000000000000000000000000000000000000000000000000000000000033
2200000000000000000000000011111110000000000000000000000000000000000000000000000000000000000000000033
2200000000000000000000001111111111100000000000000000000000000000000000000000000000000000000000000033
2200000000000000000000011111111111110000000000000000000000000000000000000000000000000000000000000033
2200000000000000000000011111111111110000000000000000000000000000000000000000000000000000000000000033
2200000000000000000000111111111111111000000000000000000000000000000000000000000000000000000000000033
2200000000000000000000111111111111111000000000000000000000000000000000000000000000000000000000000033
2200000000000000000000111111111111111000000000000000000000000000000000000000000000000000000000000033
2200000000000000000001111111111111111000000000000000000000000000000000000000000000000000000000000033
2200000000000000000000111111111111111000000000000000000000000000000000000000000000000000000000000033
2200000000000000000000111111111111111000000000000000000000000000000000000000000000000000000000000033
2200000000000000000000111111111111111000000000000000000000000000000000000000000000000000000000000033
2200000000000000000000011111111111110000000000000000000000000000000000000000000000000000000000000033
2200000000000000000000011111111111110000000000000000000000000000000000000000000000000000000000000033
2200000000000000000000001111111111100000000000000000000000000000000000000000000000000000000000000033
2200000000000000000000000011111110000000000000000000000000000000000000000000000000000000000000000033
2200000000000000000000000000000000000000000000000000000000000000000000000000000000000000000000000033
2200000000000000000000000000000000000000000000000000000000000000000000000000000000000000000000000033
2200000000000000000000000000000000000000000000000000000000000000000000000000000000000000000000000033
2200000000000000000000000000000000000000000000000000000000000000000000000000000000000000000000000033
2200000000000000000000000000000000000000000000000000000000000000000000000000000000000000000000000033
2200000000000000000000000000000000000000000000000000000000000000000000000000000000000000000000000033
2200000000000000000000000000000000000000000000000000000000000000000000000000000000000000000000000033
2200000000000000000000000000000000000000000000000000000000000000000000000000000000000000000000000033
2200000000000000000000000000000000000000000000000000000000000000000000000000000000000000000000000033
2200000000000000000000000000000000000000000000000000000000000000000000000000000000000000000000000033
2200000000000000000000000000000000000000000000000000000000000000000000000000000000000000000000000033
2200000000000000000000000000000000000000000000000000000000000000000000000000000000000000000000000033
2200000000000000000000000000000000000000000000000000000000000000000000000000000000000000000000000033
2200000000000000000000000000000000000000000000000000000000000000000000000000000000000000000000000033
2200000000000000000000000000000000000000000000000000000000000000000000000000000000000000000000000033
2200000000000000000000000000000000000000000000000000000000000000000000000000000000000000000000000033
2200000000000000000000000000000000000000000000000000000000000000000000000000000000000000000000000033
2200000000000000000000000000000000000000000000000000000000000000000000000000000000000000000000000033
2200000000000000000000000000000000000000000000000000000000000000000000000000000000000000000000000033
2200000000000000000000000000000000000000000000000000000000000000000000000000000000000000000000000033
2200000000000000000000000000000000000000000000000000000000000000000000000000000000000000000000000033
2200000000000000000000000000000000000000000000000000000000000000000000000000000000000000000000000033
2200000000000000000000000000000000000000000000000000000000000000000000000000000000000000000000000033
2200000000000000000000000000000000000000000000000000000000000000000000000000000000000000000000000033
2200000000000000000000000000000000000000000000000000000000000000000000000000000000000000000000000033
2200000000000000000000000000000000000000000000000000000000000000000000000000000000000000000000000033
2200000000000000000000000000000000000000000000000000000000000000000000000000000000000000000000000033
2200000000000000000000000000000000000000000000000000000000000000000000000000000000000000000000000033
2200000000000000000000000000000000000000000000000000000000000000000000000000000000000000000000000033
2200000000000000000000000000000000000000000000000000000000000000000000000000000000000000000000000033
2200000000000000000000000000000000000000000000000000000000000000000000000000000000000000000000000033
2200000000000000000000000000000000000000000000000000000000000000000000000000000000000000000000000033
2200000000000000000000000000000000000000000000000000000000000000000000000000000000000000000000000033
2200000000000000000000000000000000000000000000000000000000000000000000000000000000000000000000000033
2200000000000000000000000000000000000000000000000000000000000000000000000000000000000000000000000033
2200000000000000000000000000000000000000000000000000000000000000000000000000000000000000000000000033
2200000000000000000000000000000000000000000000000000000000000000000000000000000000000000000000000033
2200000000000000000000000000000000000000000000000000000000000000000000000000000000000000000000000033
2200000000000000000000000000000000000000000000000000000000000000000000000000000000000000000000000033
2200000000000000000000000000000000000000000000000000000000000000000000000000000000000000000000000033
2200000000000000000000000000000000000000000000000000000000000000000000000000000000000000000000000033
2200000000000000000000000000000000000000000000000000000000000000000000000000000000000000000000000033
1111111111111111111111111111111111111111111111111111111111111111111111111111111111111111111111111111
1111111111111111111111111111111111111111111111111111111111111111111111111111111111111111111111111111
