100, 100
1111111111111111111111111111111111111111111111111111111111111111111111111111111111111111111111111111
1111111111111111111111111111111111111111111111111111111111111111111111111111111111111111111111111111
1111111111111111111111111111111111111111111111111111111111111111111111111111111111111111111111111111
1111111111111111111111111111111111111111111111111111111111111111111111111111111111111111111111111111
1111110000000000000000000000000000000000000111111111111111111111111111111111111111111111111111111111
1111110000000000000000000000000000000000000011111111100011111111111111111111111111000000000001111111
1111110000000000000000000000000000000000000011111111000000000000000000000000000000000000000001111111
1111110000000000000000000000000000000000000011111111000000000000000000000000000000000000000001111111
1111110000000000000000000000000000000000000011111111000000000000000000000000000000000000000001111111
1111110000000000000000000000000000000000000011111111000000000000000000000000000000000000000001111111
1111110000000000000000000000000000000000000011111111000000000000000000000000000000000000000001111111
1111110000000000000000000000000000000000000011111111100000000000000000000000000000000000000001111111
1111110000000000000000000000000000000000000011111111100000000000000000000000000000000000000011111111
1111110000000000000000000000000000000000000011111111100000000000000000000000000000000000000011111111
1111110000000000000000000000000000000000000011111111100000000000000000000000000000000000000011111111
1111110000000000000000000000000000000000000001111111100000000000000000000000000000000000000011111111
1111110000000000040000000000000000000000000001111111100000000000000000000000000000000000000011111111
1111110000000044444440000000000000000000000011111111100000000000000000000000000000000000000011111111
1111110000000444444444000000000000000000000011111111100000000000000000000000000000000000000011111111
1111110000000444444444000000000000000000000011111111100000000000000000000000000000000000000011111111
1111110000000444444444000000000000000000000011111111100000000000000000000000000000000000000011111111
1111110000004444444444000000000000000000000111111111100000000000000000000000000000000000000011111111
1111110000004444444444000000000000000000000111111111100000000000000000000000000000000000000011111111
1111110000004444444444000000000000000000000111111111000000000000000000000000000000000000000011111111
1111110000004444444444000000000000000000000111111111000000000000000000000000000000000000000011111111
1111110000004444444444000000000000000000000111111111000000000000000000000000000000000000000001111111
1111110000004444444444000000000000000000000111111111000000000000000000000000000000000000000001111111
1111110000004444444444000000000000000000000111111000000000000000000000000000000000000000000001111111
1111110000004444444444000000000000000000000110110000000000000000000000000000000000000000000001111111
1111110000004444444444000000000000000000000000000000000000000000000000000000000000000000000001111111
1111110000004444444444400000000000000000000000000000000000000000000000000000000000000000000001111111
1111110000004444444444440000000000000000000000000000000000000000000000000000000000000000000001111111
1111210000004444444444440000000000000000000000000000000000000000000000000000000000000000000001111111
1222222200004444444444444000000000000000000000000000000000000000000000000000000000000000000001111111
2222222220004444444444444000000000000000000000000000000000000000000000000000000000000000000001111111
2222222220004444444444444000000000000000000000000000000000000000000000000000000000000000000001111111
2222222220004444444444444000000000000000000000000000000000000000000000000000000000000000000001111111
2222222220004444444444444000000000000000000000000000000000000000000000000000000000000000000001111111
2222222220004444444444444000000000000000000000000000000000000000000000000000000000000000000001111111
2222222220004444444444444000000000000000000000000000000000000000000000000000000000000000000003333333
2222222220004444444444444000000000000000000000000000000000000000000000000000000000000000000333333333
2222222220004444444444444000000000000000000000000000000000000000000000000000000000000000000333333333
2222222220004444444444444400000000000000000000000000000000000000000000000000000000000000000333333333
2222222220004444444444444400000000000000000000000000000000000000000000000000000000000000000333333333
2222222220004444444444444400000000000000000000000000000000000000000000000000000000000000000333333333
2222222220004444444444444440000000000000000000000000000000000000000000000000000000000000000333333333
2222222220004444444444444440000000000000000000000000000000000000000000000000000000000000000333333333
2222222220004444444444444440000000000000000000000000000000000000000000000000000000000000000333333333
2222222220000444444444444440000000000000000000000000000000000000000000000000000000000000000333333333
2222222220004444444444444440000000000000000000000000000000000000000000000000000000000000000003333333
2222222220004444444444444440000000000000000000000000000000000000000000000000000000000000000000333333
2222222220004444444444444440000000000000000000000000000000000000000000000000000000000000000000111111
2222222220004444444444444440000000000000000000000000000000000000000000000000000000000000000000111111
2222222220004444444444444440000000000000000000000000000000000000000000000000000000000000000000111111
2222222220004444444444444440000000000000000000000000000000000000000000000000000000000000000000111111
2222222220004444444444444440000000000000000000000000000000000000000000000000000000000000000000111111
1222222200004444444444444440000000000000000000000000000000000000000000000000000000000000000000111111
1111100000004444444444444440000000000000000000000000000000000000000000000000000000000000000000111111
1111100000004444444444444440000000000000000000000000000000000000000000000000000000000000000000011111
1111100000004444444444444440000000000000000000000000000000000000000000000000000000000000000000011111
1111100000004444444444444440000000000000000000000000000000000000000000000000000000000000000000011111
1111100000004444444444444440000000000000000000000000000000000000000000000000000000000000000000011111
1111100000004444444444444440000000000000000011111111000000000000000000000000000000000000000000011111
1111100000004444444444444440000000000000000011111111000000000000000000000000000000000000000000011111
1111100000004444444444444440000000000000000011111111000000000000000000000000000000000000000000011111
1111100000004444444444444440000000000000000011111111000000000000000000000000000000000000000000011111
1111100000000444444444444440000000000000000011111111000000000000000000000000000000000000000000011111
1111100000000444444444444400000000000000000011111111000000000000000000000000000000000000000000111111
1111100000000444444444444000000000000000000011111111000000000000000000000000000000000000000000111111
1111100000000044444444440000000000000000000111111111000000000000000000000000000000000000000000111111
1111100000000000000000000000000000000000000111111111000000000000000000000000000000000000000000111111
1111100000000000000000000000000000000000000111111111000000000000000000000000000000000000000000111111
1111100000000000000000000000000000000000000111111111000000000000000000000000000000000000000000111111
1111100000000000000000000000000000000000000111111111000000000000000000000000000000000000000000111111
1111100000000000000000000000000000000000000111111111000000000000000000000000000000000000000000111111
1111100000000000000000000000000000000000000111111111000000000000000000000000000000000000000000111111
1111000000000000000000000000000000000000000111111110000000000000000000000000000000000000000000111111
1111000000000000000000000000000000000000000111111110000000000000000000000000000000000000000000111111
1111000000000000000000000000000000000000000111111110000000000000000000000000000000000000000000111111
1111000000000000000044444400000000000000000111111110000000000000000000000000000000000000000000111111
1111000000000000000004444440000000000000000111111110000000000000000000000044440000000000000000111111
1111000000000000000004444440000000000000000111111110000000000000000000000044444000000000000001111111
1111000000000000000000000000000000000000000111111110000000000000000000000044444000000000000001111111
1111000000000000000000000000000000000000000111111110000000000000000000000044444000000000000001111111
1111000000000000000000000000000000000000000111111110000000000000000000000044444000000000000001111111
1111000000000000000000000000000000000000000111111110000000000000000000000000000000000000000001111111
1111000000000000000000000000000000000000000111111111000000000000000000000000000000000000000001111111
1111000000000000000000000000000000000000000111111111000000000000000000000000000000000000000001111111
1111000000000000000000000000000000000000000111111111000000000000000000000000000000000000000001111111
1111000000000000000000000000000000000000000111111111000000000000000000000000000000000000000001111111
1111000000000000000000000000000000000000000011111111000000000000000000000000000000000000000001111111
1111000000000000000000000000000000000000000011111111000000000000000000000000000000000000000001111111
1111000000000000000000000000000000000000000011111111000000000000000000000000000000000000000001111111
1111110000000000000011111111111111111111111111111111111111000000000000000000000000000000011111111111
1111110011111111111111111111111111111111111111111111111111000000000111111111111111111111111111111111
1111111111111111111111111111111111111111111111111111111111111111111111111111111111111111111111111111
1111111111111111111111111111111111111111111111111111111111111111111111111111111111111111111111111111
1111111111111111111111111111111111111111111111111111111111111111111111111111111111111111111111111111
1111111111111111111111111111111111111111111111111111111111111111111111111111111111111111111111111111
1111111111111111111111111111111111111111111111111111111111111111111111111111111111111111111111111111
