100, 100
1111111111111111111111111111111111111111111111111111111111111111111111111111111111111111111111111111
1111111111111111111111111111111111111111111111111111111111111111111111111111111111111111111111111111
1111111111111111111111111111111111111111111111111111111111111111111111111111111111111111111111111111
1111111111111111111111111111111111111111111111111111111111111111111111111111111111111111111111111111
1111110000000000000000000000000000000000000111111111111111111111111111111111111111111111111111111111
1111110000000000000000000000000000000000000011111111100011111111111111111111111111000000000001111111
1111110000000000000000000000000000000000000011111111000000000000000000000000000000000000000001111111
1111110000000000000000000000000000000000000011111111000000000000000000000000000000000000000001111111
1111110000000000000000000000000000000000000011111111000000000000000000000000000000000000000001111111
1111110000000000000000000000000000000000000011111111000000000000000000000000000000000000000001111111
1111110000000000000000000000000000000000000011111111000000000000000000000000000000000000000001111111
1111110000000000000000000000000000000000000011111111100000000000000000000000000000000000000001111111
1111110000000000400440000000000000000000000011111111100000000000000000000000000000000000000011111111
1111110000000444444444440000000000000000000011111111100000000000000000000000000000000000000011111111
1111110000004444444444444000000000000000000011111111100000000000000000000000000000000000000011111111
1111110000004444444444444400000000000000000001111111100000000000000000000000000000000000000011111111
1111110000004444444444444400000000000000000001111111100000000000000000000000000000000000000011111111
1111110000044444444444444400000000000000000011111111100000000000000000000000000000000000000011111111
1111110000044444444444444400000000000000000011111111100000000000000000000000000000000000000011111111
1111110000444444444444444400000000000000000011111111100000000000000000000000000000000000000011111111
1111110000444444444444444400000000000000000011111111100000000000000000000000000000000000000011111111
1111110000444444444444444400000000000000000111111111100000000000000000000000000000000000000011111111
1111110004444444444444444400000000000000000111111111100000000000000000000000000000000000000011111111
1111110004444444444444444400000000000000000111111111000000000000000000000000000000000000000011111111
1111110004444444444444444400000000000000000111111111000000000000000000000000000000000000000011111111
1111110044444444444444444000000000000000000111111111000000000000000000000000000000000000000001111111
1111110044444444444444444400000000000000000111111111000000000000000000000000000000000000000001111111
1111110044444444444444444444400000000000000111111000000000000000000000000000000000000000000001111111
1111110044444444444444444444440000000000000110110000000000000000000000000000000000000000000001111111
1111110044444444444444444444440000000000000000000000000000000000000000000000000000000000000001111111
1111110044444444444444444444440000000000000000000000000000000000000000000000000000000000000001111111
1111110044444444444444444444440000000000000000000000000000000000000000000000000000000000000001111111
1111210044444444444444444444440000000000000000000000000000000005000000000000000000000000000001111111
1222222204444444444444444444440000000000000000000000000000005555555000000000000000000000000001111111
2222222224444444444444444444440000000000000000000000000000055555555500000000000000000000000001111111
2222222224444444444444444444400000000000000000000000000000055555555500000000000000000000000001111111
2222222224444444444444444444000000000000000000000000000000055555555500000000000000000000000001111111
2222222224444444444444444444000000000000000000000000000005555555555500000000000000000000000001111111
2222222220444444444444444440000000000000000000000000000055555555555500000000000000000000000001111111
2222222220444444444444444444440000000000000000000000000055555555555500000000000000000000000003333333
2222222220444444444444444444444000000000000000000000000055555555555500000000000000000000000333333333
2222222220044444444444444444444400000000000000000000000555555555555000000000000000000000000333333333
2222222220044444444444444444444400000000000000000000000055555555550000000000000000000000000333333333
2222222220044444444444444444444440000000000000000000000055555555555000000000000000000000000333333333
2222222220044444444444444444444440000000000000000000000555555555555500000000000000000000000333333333
2222222220444444444444444444444440000000000000000000000055555555555550000000000000000000000333333333
2222222220444444444444444444444440000000000000000000000055555555555555000000000000000000000333333333
2222222220444444444444444444444440000000000000000000000055555555555555000000000000000000000333333333
2222222220044444444444444444444440000000000000000000000005555555555555000000000000000000000333333333
2222222220044444444444444444444440000000000000000000000000555555555555000000000000000000000003333333
2222222220044444444444444444444400000000000000000000000000055555555555000000000000000000000000333333
2222222220044444444444444444444400000000000000000000000000005555555555000000000000000000000000111111
2222222220044444444444444444444000000000000000000000000000000555555555000000000000000000000000111111
2222222220444444444444444444444000000000000000000000000000000555555555000000000000000000000000111111
2222222220444444444444444444444000000000000000000000000000000055555550000000000000000000000000111111
2222222220444444444444444444444000000000000000000000000000000000000000000000000000000000000000111111
1222222204444444444444444444444000000000000000000000000000000000000000000000000000000000000000111111
1111100004444444444444444444440000000000000000000000000000000000000000000000000000000000000000111111
1111100004444444444444444444440000000000000000000000000000000000000000000000000000000000000000011111
1111100044444444444444444444440000000000000000000000000000000000000000000000000000000000000000011111
1111100044444444444444444444440000000000000000000000000000000000000000000000000000000000000000011111
1111100004444444444444444444400000000000000000000000000000000000000000000000000000000000000000011111
1111100004444444444444444444000000000000000011111111000000000000000000000000000000000000000000011111
1111100004444444444444444444000000000000000011111111000000000000000000000000000000000000000000011111
1111100000444444444444444444000000000000000011111111000000000000000000000000000000000000000000011111
1111100000444444444444444444000000000000000011111111000000000000000000000000000000000000000000011111
1111100000444444444444444444000000000000000011111111000000000000000000000000000000000000000000011111
1111100000044444444444444444000000000000000011111111000000000000000000000000000000000000000000111111
1111100000004444444444444444000000000000000011111111000000000000000000000000000000000000000000111111
1111100000004444444444444440000000000000000111111111000000000000000000000000000000000000000000111111
1111100000004444444444444000000000000000000111111111000000000000000000000000000000000000000000111111
1111100000000444444444400000000000000000000111111111000000000000000000000000000000000000000000111111
1111100000000000000000000000000000000000000111111111000000000000000000000000000000000000000000111111
1111100000000000000000000000000000000000000111111111000000000000000000000000000000000000000000111111
1111100000000000000000050000000000000000000111111111000000000000000000000000000000000000000000111111
1111100000000000000055555550000000000000000111111111000000000000000000000000000000000000000000111111
1111000000000000000555555555000000000000000111111110000000000000000000000000000000000000000000111111
1111000000000000000555555555000000000000000111111110000000000000000000000055000000000000000000111111
1111000000000000000555555555000000000000000111111110000000000000000000055555555000000000000000111111
1111000000000000005555555555000000000000000111111110000000000000000000555555555500000000000000111111
1111000000000000005555555555000000000000000111111110000000000000000000555555555500000000000000111111
1111000000000000000555555555000000000000000111111110000000000000000000555555555500000000000001111111
1111000000000000000555555555000000000000000111111110000000000000000005555555555500000000000001111111
1111000000000000000555555555000000000000000111111110000000000000000000555555555500000000000001111111
1111000000000000000055555550000000000000000111111110000000000000000000555555555500000000000001111111
1111000000000000000000000000000000000000000111111110000000000000000000555555555500000000000001111111
1111000000000000000000000000000000000000000111111111000000000000000000055555555000000000000001111111
1111000000000000000000000000000000000000000111111111000000000000000000000000000000000000000001111111
1111000000000000000000000000000000000000000111111111000000000000000000000000000000000000000001111111
1111000000000000000000000000000000000000000111111111000000000000000000000000000000000000000001111111
1111000000000000000000000000000000000000000011111111000000000000000000000000000000000000000001111111
1111000000000000000000000000000000000000000011111111000000000000000000000000000000000000000001111111
1111000000000000000000000000000000000000000011111111000000000000000000000000000000000000000001111111
1111110000000000000011111111111111111111111111111111111111000000000000000000000000000000011111111111
1111110011111111111111111111111111111111111111111111111111000000000111111111111111111111111111111111
1111111111111111111111111111111111111111111111111111111111111111111111111111111111111111111111111111
1111111111111111111111111111111111111111111111111111111111111111111111111111111111111111111111111111
1111111111111111111111111111111111111111111111111111111111111111111111111111111111111111111111111111
1111111111111111111111111111111111111111111111111111111111111111111111111111111111111111111111111111
1111111111111111111111111111111111111111111111111111111111111111111111111111111111111111111111111111
