100, 100
1111111111111111111111111111111111111111333333333333333333311111111111111111111111111111111111111111
1111111111111111111111111111111111111111333333333333333333311111111111111111111111111111111111111111
1100000000000000000000000000000000000000000000000000000000001100000000000000000000000000000000000011
3300000000000000000000000000000000000000000000000000000000001100000000000000000000000000000000000011
3300000000000000000000000000000000000000000000000000000000001100000000000000000000000000000000000011
3300000000000000000000000000000000000000000000000000000000001100000000000000000000000000000000000033
3300000000000000000000000000000000000000000000000000000000001100000000000000000000000000000000000033
3300000000000000000000000000000000000000000000005555000000001100000000000000000000000000000000000033
3300000000000000000000000000000000000000000000005555000000001100000000000000000000000000000000000033
3300000000000000000000000000000000000000000000005555000000000000000000000000000000000000000000000033
3300000000000000000000000000000000000000000000005555000000000000000000000000000000000000000000000011
3300000000000000000000000000000000000000000000000000000000000000000000000000000000000000000000000011
1100000000000000000000000000000000000000000000000000000000000000000000000000000000000000000000000011
1111111111111111111111111111111111111110000000000000000000000000000000000000000000000000000000000011
1111111111111111111111111111111111111110000000000000000000000000000000000000000000000000000000000011
1144444444444444444444444444444444444110000000000000000000000000000000000000000000000000000000000011
1144444444444444444444444444444444444110000000000000000000000000000000000000005555000000000000000011
1144444444444444444444444444444444444110000000000000000000000000000000000000005555000000000000000011
1144444444444444444444444444444444444110000000000000000000000000000000000000005555000000000000000011
1144444444444444444444444444444444444110000000000000000000000000000000000000005555000000000000000011
1144444444444444444444444444444444444110000000000000000000001100000000000000000000000000000000000011
1144444444444444444444444444444444444000000000000000000000001200000000000000000000000000000000000011
3344444444444444444444444444444444444000000000000000000000001200000000000000000000000000000000000011
3344444444444444444444444444444444444000000000000000000000001200000000000000000000000000000000000011
3344444444444444444444444444444444444000000000000000000000001111111111111111111111111111111111111111
3344444444444444444444444444444444444000000000000000000000001111111111111111111111111111111111111111
3344444444444444444444444444444444444000000000000000000000001100000000000000000000000000000000000011
3344444444444444444444444444444444444000000000000000000000001100000000000000000000000000000000000011
1144444444444444444444444444444444444000000000000000000000001100000000000000000000000000000000000011
1144444444444444444444444444444444444000000000000000000000001100000000000000000000000000000000000011
1144444444444444444444444444444444444110000000000000000000001100000000000000000000000000000000000011
1144444444444444444444444444444444444110000000000000000000001100000000000000000000000000000000000033
1144444444444444444444444444444444444110000000000000000000001100000000000000000000000000000000000033
1144444444444444444444444444444444444110000000000000000000001100000000000000000000000000000000000033
1144444444444444444444444444444444444110000000000000000000001100000000000000000000000000000000000033
1144444444444444444444444444444444444110000000000000000000001100000000000000000000000000000000000033
1144444444444444444444444444444444444110000000000000000000001100000000000000000000000000000000000033
1144444444444444444444444444444444444110000000000000000000001100000000000000000000000000000000000011
1244444444444444444444444444444444444110000000000000000000001100000000000000000000000000000000000011
1244444444444444444444444444444444444110000000000000000000001100000000000000000000000000000000000011
1244444444444444444444444444444444444110000000000000000000000000000000000000000000000000000000000011
1144444444444444444444444444444444444110000000000000000000000000000000000000000000000000000000000011
1111111111111111111111111111111111111110000000000000000000000000000000000000000000000000000000000011
1111111111111111111111111111111111111110000000000000000000000000000000000000000000000000000000000011
1144444444444444444444444444444444444110000000000000000000000000000000000000000000000000000000000011
1144444444444444444444444444444444444110000000000000000000000000000000000000555500000000000000000011
1144444444444444444444444444444444444110000000000000000000000000000000000000555500000000000000000011
1144444444444444444444444444444444444110000000000000000000000000000000000000555500000000000000000011
1144444444444444444444444444444444444110000000000000000000000000000000000000555500000000000000000011
1144444444444444444444444444444444444110000000000000000000000000000000000000000000000000000000000011
1144444444444444444444444444444444444110000000000000000000001100000000000000000000000000000000000011
3344444444444444444444444444444444444110000000000000000000001100000000000000000000000000000000000011
3344444444444444444444444444444444444110000000000000000000001100000000000000000000000000000000000011
3344444444444444444444444444444444444110000000000000000000001100000000000000000000000000000000000011
3344444444444444444444444444444444444000000000000000000000001100000000000000000000000000000000000011
3344444444444444444444444444444444444000000000000000000000001100000000000000000000000000000000000011
3344444444444444444444444444444444444000000000000000000000001100000000000000000000000000000000000011
1144444444444444444444444444444444444000000000000000000000001100000000000000000000000000000000000011
1144444444444444444444444444444444444000000000000000000000001200000000000000000000000000000000000011
1144444444444444444444444444444444444000000000000000000000001200000000000000000000000000000000000011
1144444444444444444444444444444444444000000000000000000000001200000000000000000000000000000000000011
1144444444444444444444444444444444444000000000000000000000001100000000000000000000000000000000000011
1144444444444444444444444444444444444000000000000000000000001111111111111111111111111111111111111111
1144444444444444444444444444444444444000000000000000000000001111111111111111111111111111111111111111
1144444444444444444444444444444444444110000000000000000000001100000000000000000000000000000000000011
1144444444444444444444444444444444444110000000000000000000001100000000000000000000000000000000000011
1144444444444444444444444444444444444110000000000000000000001100000000000000000000000000000000000011
1144444444444444444444444444444444444110000000000000000000001100000000000000000000000000000000000011
1144444444444444444444444444444444444110000000000000000000001100000000000000000000000000000000000033
1144444444444444444444444444444444444110000000000000000000001100000000000000000000000000000000000033
1144444444444444444444444444444444444110000000000000000000001100000000000000000000000000000000000033
1144444444444444444444444444444444444110000000000000000000001100000000000000000000000000000000000033
1244444444444444444444444444444444444110000000000000000000001100000000000000005555000000000000000033
1244444444444444444444444444444444444110000000000000000000000000000000000000005555000000000000000033
1244444444444444444444444444444444444110000000000000000000000000000000000000005555000000000000000033
1144444444444444444444444444444444444110000000000000000000000000000000000000005555000000000000000011
1111111111111111111111111111111111111110000000000000000000000000000000000000000000000000000000000011
1111111111111111111111111111111111111110000000000000000000000000000000000000000000000000000000000011
1144444444444444444444444444444444444110000000000000000000000000000000000000000000000000000000000011
1144444444444444444444444444444444444110000000000000000000000000000000000000000000000000000000000011
1144444444444444444444444444444444444110000000000000000000000000000000000000000000000000000000000011
3344444444444444444444444444444444444110000000000000000000000000000000000000000000000000000000000011
3344444444444444444444444444444444444110000000000000000000000000000000000000000000000000000000000011
3344444444444444444444444444444444444000000000000000000000000000000000000000000000000000000000000011
3344444444444444444444444444444444444000000000000000000000001100000000000000000000000000000000000011
3344444444444444444444444444444444444000000000000000000000001100000000000000000000000000000000000011
1144444444444444444444444444444444444000000000000000000000001100000000000000000000000000000000000011
1144444444444444444444444444444444444000000000000000000000001100000000000000000000000000000000000011
1144444444444444444444444444444444444000000000000000000000001100000000000000000000000000000000000011
1144444444444444444444444444444444444000000000000000000000001100000000000000000000000000000000000011
1144444444444444444444444444444444444000000000000000000000001100000000000000000000000000000000000011
1144444444444444444444444444444444444110000000000000000000001100000000000000000000000000000000000011
1144444444444444444444444444444444444110000000055550000000001100000000000000000000000000000000000011
1144444444444444444444444444444444444110000000055550000000001200000000000000000000000000000000000011
1244444444444444444444444444444444444110000000055550000000001200000000000000000000000000000000000011
1244444444444444444444444444444444444110000000055550000000001200000000000000000000000000000000000011
1244444444444444444444444444444444444110000000000000000000001100000000000000000000000000000000000011
1144444444444444444444444444444444444110000000000000000000001100000000000000000000000000000000000011
1111111111111111111111111111111111111113333333333333333333311111111111111111111111111111111111111111
1111111111111111111111111111111111111113333333333333333333311111111111111111111111111111111111111111
